Queen - Bohemian Rhapsody
The Beatles - Hey Jude
Led Zeppelin - Stairway to Heaven
Pink Floyd - Comfortably Numb
Nirvana - Smells Like Teen Spirit
Metallica - Nothing Else Matters
Guns N’ Roses - Sweet Child O’ Mine
AC/DC - Back in Black
U2 - With or Without You
Radiohead - Creep
Red Hot Chili Peppers - Californication
The Rolling Stones - Paint It Black
Aerosmith - Dream On
Bon Jovi - Livin’ on a Prayer
Coldplay - Viva La Vida
Linkin Park - In the End
Foo Fighters - Everlong
Pearl Jam - Alive
Green Day - Boulevard of Broken Dreams
Imagine Dragons - Demons
Arctic Monkeys - Do I Wanna Know?
Oasis - Wonderwall
The Killers - Mr. Brightside
Evanescence - Bring Me to Life
System of a Down - Chop Suey!
Creed - My Sacrifice
Dire Straits - Sultans of Swing
Scorpions - Wind of Change
Iron Maiden - Fear of the Dark
Black Sabbath - Paranoid
Legião Urbana - Tempo Perdido
Charlie Brown Jr. - Zoio de Lula
Engenheiros do Hawaii - Infinita Highway
Titãs - Epitáfio
Os Paralamas do Sucesso - Alagados
Capital Inicial - Primeiros Erros
Raimundos - Mulher de Fases
Skank - Garota Nacional
Barão Vermelho - Pro Dia Nascer Feliz
Cazuza - Exagerado
Imagine Dragons - Believer
The Police - Every Breath You Take
Simple Plan - Welcome to My Life
Blink-182 - All the Small Things
Paramore - Decode
Avenged Sevenfold - So Far Away
Three Days Grace - Animal I Have Become
Kings of Leon - Use Somebody
The Cranberries - Zombie
Audioslave - Like a Stone